TTRTRTRTTTRTTR
T         RT R
T T RT RT RTTR
T TTT   R    R
T T T TTT  TTR
T T     RT TRR
T T R R TR TTR
T T  T  R  T R
T RR TT   RTTR
T     TT  GGGR
TTTRTTTTTTTTTR
